0   0x13f
1   0x13d
2   0x13b
3   0x139
4   0x137
5   0x135
6   0x133
7   0x131
8   0x12f
9   0x12d
10  0x12b
11  0x129
12  0x127
13  0x125
14  0x123
15  0x121
 
